NO ./textures/eagle.xpm
SO ./textures/greystone.xpm
WE ./textures/purplestone.xpm
EA ./textures/red.xpm

F 150,150,150
C 100,100,100

 111    11111111111111111111111111111111
 101    10000000001100000000W00000000001
 111    10110000011100101010101011010101
        10010000000000101010101011010101
        10110000011111111111111111111111
        10110000000000000000000000000001
        10010000000000000000000000000001
        10110000000000000000000000000001
        10010000000000000000000000000001
        10110000000010000000100000000001
        10010000000001000001000000000001
        10110000000000000000000000000001
        10010000000000000000000000000001
        10110000000000000000000000000001
        10010000000001000001000000000001
        10110000000010000000100000000001
        10010000000000000000000000000001
        10110000000000000000000000000001
        10011111111111111111111111111111
        1011
        1001
        1011
        1001
        1011
        1001
        1011
        1011
        1001
        1011
        1001
        1011
        1001
        1011
        1011
        1001
        1011
        1001
        1011
        1001
        1011
        1011
        1001
        1011
        1001
        1011
        1001
        1011
        1011
        1001
        1011
        1001
        1011
        1001
        1011
        1011
        1001
        1011
        1001
        1011
        1001
        1011
        1011
        1001
        1011
        1001
        1011
        1001
        1011
        1011
        1001
        1011
        1001
        1011
        1001
        1011
        1011
        1001
        1011
        1001
        1011
        1001
        1011
        1011
        1001
        1011
        1001
        1011
        1001
        1011
        1011
        1001
        1011
        1001
        1011
        1001
        1011
        1011
        1001
        1011
        1001
        1011
        1001
        1011
        1011
        1001
        1011
        1001
        1011
        1001
        1011
        1011
        1001
        1011
        1001
        1011
        1001
        1011
        1011
        1001
        1011
        1001
        1011
        1001
        1011
        1011
        1001
        1011
        1001
        1011
        1001
        1011
        1011
        1001
        1011
        1001
        1011
        1001
        1011
        1011
        1001
        1011
        1001
        1011
        1001
        1011
        1011
        1001
        1011
        1001
        1011
        1001
        1011
        1011
        1001
        1011
        1001
        1011
        1001
        1011
        1011
        1001
        1011
        1001
        1011
        1001
        1011
        1011
        1001
        1011
        1001
        1011
        1001
        1011
        1011
        1001
        1011
        1001
        1011
        1001
        1011
        1011
        1001
        1011
        1001
        1011
        1001
        1011
        1111
