NO ./textures/eagle.xpm
SO ./textures/greystone.xpm
WE ./textures/purplestone.xpm
EA ./textures/red.xpm

F 150,150,150
C 100,100,100

 111    1111111111111111111111111111111111111111111111111111111111111111111111111111111111111111111111111111111111111111111111111111111111111111111111111111111111111111111111111111111111111111111111111111111111111111111111111111111111111111111111111111111111111111111111111111111111111111111111111111111111111111111111111111111111111111111111111111111111111111111111111111111111111111111111111111111111111111111
 101    1000000000110000000000000000000000000000000000000000000000000000000000000000000000000000000000000000000000000000000000000000000000000000000000000000000000000000000000000000000000000000000000000000000000000000000000000000000000000000000000000000000000000000000000000000000000000000000000000000000000000000000000000000000000000000000000000000000000000000000000000000000000000000000000000000000000000000001
 111    1011000001110010101010101101010111111111111111111111111111111111111111111111111111111111111111111111111111111111111111111111111111111111111111111111111111111111111111111111111111111111111111111111111111111111111111111111111111111111111111111111111111111111111111111111111111111111111111111111111111111111111111111111111111111111111111111111111111111111111111111111111111111111111111111111111111111111101
        10010000000000101010101011010101                                                                                                                                                                                                                                                                                                                                                                                111 
        10110000011111111111111111111111
        10110000000000000000000000000001
        10010000000000000000000000000001
        10110000000000W00000000000000001
        10010000000000000000000000000001
        10110000000010000000100000000001
        10010000000001000001000000000001
        10110000000000000000000000000001
        10010000000000000000000000000001
        10110000000000000000000000000001
        10010000000001000001000000000001
        10110000000010000000100000000001
        10010000000000000000000000000001
        10110000000000000000000000000001
        10011111111111111111111111111111
        1011
        1001
        1011
        1001
        1011
        1001
        1011
        1011
        1001
        1011
        1001
        1011
        1001
        1011
        1011
        1001
        1011
        1001
        1011
        1001
        1011
        1011
        1001
        1011
        1001
        1011
        1001
        1011
        1011
        1001
        1011
        1001
        1011
        1001
        1011
        1011
        1001
        1011
        1001
        1011
        1001
        1011
        1011
        1001
        1011
        1001
        1011
        1001
        1011
        1011
        1001
        1011
        1001
        1011
        1001
        1011
        1011
        1001
        1011
        1001
        1011
        1001
        1011
        1011
        1001
        1011
        1001
        1011
        1001
        1011
        1011
        1001
        1011
        1001
        1011
        1001
        1011
        1011
        1001
        1011
        1001
        1011
        1001
        1011
        1011
        1001
        1011
        1001
        1011
        1001
        1011
        1011
        1001
        1011
        1001
        1011
        1001
        1011
        1011
        1001
        1011
        1001
        1011
        1001
        1011
        1011
        1001
        1011
        1001
        1011
        1001
        1011
        1011
        1001
        1011
        1001
        1011
        1001
        1011
        1011
        1001
        1011
        1001
        1011
        1001
        1011
        1011
        1001
        1011
        1001
        1011
        1001
        1011
        1011
        1001
        1011
        1001
        1011
        1001
        1011
        1011
        1001
        1011
        1001
        1011
        1001
        1011
        1011
        1001
        1011
        1001
        1011
        1001
        1011
        1011
        1001
        1011
        1001
        1011
        1001
        1011
        1011
        1001
        1011
        1001
        1011
        1001
        1011
        1111
